#---------
#------###
#-----#---
#-----#---
------#---
---##-----
----------
----------
-----####-
----------